SO ./textures/stone2.xpm
NO ./textures/stone12.xpm
WE ./textures/stone3.xpm
EA ./textures/stone4.xpm

F        0,0,3
C 255,255,255

1
11111111111111111111
10000001000000000001
10000001000001000001
10N00001000001000001
10000001000001000001 111
10000000000001000001 100000000 1
11111111111111111111 111
