SO ./textures/kaynito.xpm
NO ./textures/yummi_edg.xpm
WE ./textures/profyum.xpm
EA ./textures/yumyum.xpm

C 84,171,179
F 240,211,117

1
11111111111111111111
10000001000000000001
10000001000001000001111111111111111111
10W00001000001000000000000000000000001
10000001000001000001111111111111111101
10000001000001000001               101
10000001000001000001   0000000     101
10000001000001000001   0000000     101
10000001000001000001               101
10000001000001000001111111111111111101
10000001000001000000000000000000000001
10000001000001000001111111111111111111
10000000000001000001
10000000000001000001 100000001
1111111111111111111111111111111