1111111111111111111111111111
1111111111111S11111111111111
1111111111111W11111111111111
1111111111111E11111111111111
1111111111110111111111111111
1111111111111N11111111111111
1111111111111111111111111111
1111111111111111111111111111
