NO ./textures/north64.xpm
SO ./textures/south64.xpm
WE ./textures/west64.xpm
EA ./textures/east64.xpm
F 4,100,0
C 225,0,255

11111111111111111111111111111111111111111111111111111111111111111111111111111111111111
1N101111111111111111111111111111111111111111111111111
11111
111111