NO ./textures/stone12.xpm
SO ./textures/stone2.xpm
WE ./textures/stone3.xpm
EA ./textures/stone4.xpm

F 4,100,1
C 225,0,255

11111111111111111111
10000001000000000001
10000001000001000001
10W00001000001000001
10000001000001000001
10000000000001000001
11111111111111111111