SO ./textures/stone2.xpm
NO ./textures/stone12.xpm
WE ./textures/stone3.xpm
EA ./textures/stone4.xpm

F        0,0,3
C 255,255,255

1
11111111111111111111
10000001000000000001
10000001000001000001111111111111111111
10W00001000001000000000000000000000001
10000001000001000001111111111111111101
10000001000001000001               101
10000001000001000001   0000000     101  00000000001
10000001000001000001   0000000     101  00000000001
10000001000001000001               101
10000001000001000001111111111111111101
10000001000001000000000000000000000001
10000001000001000001111111111111111111
10000000000001000001
10000000000001000001 100000001
111111111111111111111111111111111111111111111111111