NO ./textures/north64.xpm
SO ./textures/south64.xpm
WE ./textures/west64.xpm
EA ./textures/east64.xpm
F 4,100,0
C 225,0,0




1111111111111111111111111
1000000000110000000000001
1011000001110000000000001
1001000000000000000000001
100000000000000000000000001
100000000011000001110111111111111
11110111111111011100000000001
11110111111111011101010010001
11000000110101011100000010001
10000000000000001100000010001
10000000000000000001010010001
110000011101010111110111100011
11110111 1110101 1011110100N1
11111111111111111111111111111